Archipelago Version 0.6.4  -  Seed: 1

Filling Algorithm:               balanced
Players:                         1
Plando Options:                  connections, texts, bosses
Game:                            Terraria
Progression Balancing:           50
Accessibility:                   Full
Local Items:                     
Non-local Items:                 
Start Inventory:                 
Start Hints:                     
Start Location Hints:            
Excluded Locations:              
Priority Locations:              
Item Links:                      
Plando Items:                    
Calamity Mod Integration:        No
"getfixedboi" Seed:              No
Goal:                            Mechanical Bosses
Early Pre-Hardmode Achievements: Yes
Normal Achievements:             Yes
Grindy Achievements:             No
Fishing Quest Achievements:      No
Fill Extra Checks With:          Useful Items
Death Link:                      No


Locations:

Copper Shortsword: Copper Shortsword
Guide: Guide
Squire Slime: Squire Slime
Traveling Merchant: Traveling Merchant
Lifeform Analyzer: Lifeform Analyzer
DPS Meter: DPS Meter
Stopwatch: Stopwatch
Timber!!: Reward: Rod of Discord
Benched: Reward: Flipper
Stop! Hammer Time!: Reward: DPS Meter
Matching Attire: Reward: Torch God's Favor
Fashion Statement: Reward: Ice Skates
Ooo! Shiny!: Reward: Armor Polish
No Hobo: Reward: Celestial Magnet
Merchant: Merchant
Bug Net: Bug Net
Heavy Metal: Post-King Slime
Dye Trader: Dye Trader
Dye Hard: Reward: Lucky Coin
Demolitionist: Demolitionist
Lucky Break: Reward: Weather Radio
Star Power: Reward: Hermes Boots
You Can Do It!: Reward: Gold Ring
Cactus: Cactus
Unusual Survival Strategies: Post-Old One's Army Tier 1
Aglet: Aglet
Radar: Radar
Wand of Sparking: Wand of Sparking
Heliophobia: Reward: Feral Claws
Evil Powder: Evil Powder
Zoologist: Zoologist
Cat: Cat
Feeling Petty: Reward: Lava Charm
Dog: Dog
Painter: Painter
Enchanted Sword: Enchanted Sword
Angler: Angler
Fisherman's Pocket Guide: Fisherman's Pocket Guide
Weather Radio: Weather Radio
Sextant: Sextant
Water Walking Boots: Water Walking Boots
Into Orbit: Reward: Stopwatch
Starfury: Starfury
Celestial Magnet: Celestial Magnet
Clumsy Slime: Clumsy Slime
Watch Your Step!: Reward: Climbing Claws
Throwing Lines: Reward: Sextant
Torch God: Post-Eye of Cthulhu
Vehicular Manslaughter: Post-Pirate Invasion
Depth Meter: Depth Meter
Compass: Compass
Hey! Listen!: Reward: Fledgling Wings
I Am Loot!: Reward: Lavaproof Fishing Hook
Magic Mirror: Magic Mirror
Heart Breaker: Post-Deerclops
Nurse: Nurse
The Frequent Flyer: Post-Goblin Army
Feast of Midas: Reward: Moon Charm
Hold on Tight!: Reward: Titan Glove
Gold Hammer: Gold Hammer
Gold Pickaxe: Gold Pickaxe
Gold Watch: Gold Watch
Like a Boss: Reward: Star Cloak
Hermes Boots: Hermes Boots
Jeepers Creepers: Reward: Demon Conch
Stylist: Stylist
Funkytown: Reward: Fast Clock
Metal Detector: Metal Detector
Dead Men Tell No Tales: Reward: Treasure Magnet
Obsidian: Obsidian
Obsidian Skull: Obsidian Skull
Lava Charm: Lava Charm
Demonite Ore: Demonite Ore
Demonite Bar: Demonite Bar
Evil Sword: Evil Sword
Ice Skates: Ice Skates
Flinx Fur Coat: Flinx Fur Coat
Golfer: Golfer
Party Girl: Party Girl
Cool Slime: Cool Slime
Anklet of the Wind: Anklet of the Wind
Feral Claws: Feral Claws
Stinger: Stinger
Jungle Spores: Jungle Spores
Vine: Vine
Blade of Grass: Blade of Grass
Nature's Gift: Nature's Gift
Bezoar: Bezoar
Summoning Potion: Summoning Potion
A Shimmer In The Dark: Reward: Shoe Spikes
It's Getting Hot in Here: Reward: Ancient Chisel
Rock Bottom: Post-Queen Slime
Obsidian Rose: Obsidian Rose
Magma Stone: Magma Stone
Smashing, Poppet!: Reward: Putrid Scent
Arms Dealer: Arms Dealer
Leading Landlord: Reward: Cloud in a Bottle
Completely Awesome: Post-Skeletron
Illegal Gun Parts: Illegal Gun Parts
King Slime: Reward: Nazar
The Cavalry: Reward: Red Counterweight
Solidifier: Solidifier
Nerdy Slime: Nerdy Slime
Sandstorm: Sandstorm
Shark Tooth Necklace: Shark Tooth Necklace
Quiet Neighborhood: Reward: Black Belt
Surly Slime: Surly Slime
Eye of Cthulhu: Reward: Paint Sprayer
Dryad: Dryad
Pumpkin Seeds: Pumpkin Seeds
Pumpkin: Pumpkin
Purification Powder: Purification Powder
Mystic Slime: Mystic Slime
Evil Boss: Reward: Megaphone
Evil Boss Part: Evil Boss Part
Evil Pickaxe: Evil Pickaxe
Obsidian Armor: Obsidian Armor
Tavernkeep: Tavernkeep
Old One's Army Tier 1: Reward: Nature's Gift
Meteorite: Meteorite
Meteorite Bar: Meteorite Bar
Meteor Hamaxe: Meteor Hamaxe
Hellforge: Hellforge
Hellstone: Hellstone
Hellstone Bar: Hellstone Bar
Fiery Greatsword: Fiery Greatsword
Molten Hamaxe: Molten Hamaxe
Molten Pickaxe: Molten Pickaxe
Miner for Fire: Hardmode
Hot Reels!: Reward: Flying Carpet
Goblin Army: Reward: Rifle Scope
Goblin Tinkerer: Goblin Tinkerer
Tinkerer's Workshop: Tinkerer's Workshop
Mana Flower: Mana Flower
Rocket Boots: Rocket Boots
Spectre Boots: Spectre Boots
Lightning Boots: Lightning Boots
Frostspark Boots: Frostspark Boots
Lava Waders: Lava Waders
Terraspark Boots: Terraspark Boots
GPS: GPS
Goblin Tech: Goblin Tech
Fish Finder: Fish Finder
Diving Gear: Diving Gear
Where's My Honey?: Reward: Brick Layer
Queen Bee: Reward: Step Stool
Bee Keeper: Bee Keeper
Bee Wax: Bee Wax
Bee Armor: Bee Armor
Not the Bees!: Reward: Neptune's Shell
Witch Doctor: Witch Doctor
Pygmy Necklace: Pygmy Necklace
Skeletron: Reward: Yoyo Glove
Clothier: Clothier
Dungeon: Dungeon
Dungeon Heist: Reward: Magic Mirror
Bone: Bone
Tally Counter: Tally Counter
R.E.K. 3000: R.E.K. 3000
PDA: PDA
Cell Phone: Cell Phone
Bewitching Table: Bewitching Table
Alchemy Table: Alchemy Table
Mechanic: Mechanic
Wire: Wire
Actuator: Actuator
Muramasa: Muramasa
Cobalt Shield: Cobalt Shield
Obsidian Shield: Obsidian Shield
Elder Slime: Elder Slime
Deerclops: Reward: Magic Conch
Night's Edge: Night's Edge
Wall of Flesh: Reward: Shark Tooth Necklace
Pwnhammer: Pwnhammer
Emblem: Emblem
Fast Clock: Fast Clock
Wizard: Wizard
Titan Glove: Titan Glove
Power Glove: Power Glove
Magic Quiver: Magic Quiver
Hallowed Seeds: Hallowed Seeds
Armor Polish: Armor Polish
Adhesive Bandage: Adhesive Bandage
Medicated Bandage: Medicated Bandage
Megaphone: Megaphone
Pocket Mirror: Pocket Mirror
Trifold Map: Trifold Map
The Plan: The Plan
Tax Collector: Tax Collector
Spider Fangs: Spider Fangs
Spider Armor: Spider Armor
Cross Necklace: Cross Necklace
Altar: Altar
Begone, Evil!: Reward: Obsidian Rose
Cobalt Ore: Cobalt Ore
Extra Shiny!: Reward: Water Walking Boots
Cobalt Bar: Cobalt Bar
Cobalt Pickaxe: Cobalt Pickaxe
Blindfold: Blindfold
Reflective Shades: Reflective Shades
Vitamins: Vitamins
Armor Bracing: Armor Bracing
Nazar: Nazar
Countercurse Mantra: Countercurse Mantra
Ankh Charm: Ankh Charm
Ankh Shield: Ankh Shield
Soul of Night: Soul of Night
Hallow: Hallow
Pixie Dust: Pixie Dust
Holy Water: Holy Water
Unicorn Horn: Unicorn Horn
Crystal Shard: Crystal Shard
Soul of Light: Soul of Light
Meteor Staff: Meteor Staff
Blessed Apple: Blessed Apple
Rod of Discord: Rod of Discord
Soul of Flight: Soul of Flight
Head in the Clouds: Reward: Fisherman's Pocket Guide
Bunny: Bunny
Forbidden Fragment: Forbidden Fragment
Don't Dread on Me: Reward: Trifold Map
Truffle: Truffle
It Can Talk?!: Reward: Tally Counter
Pirate Invasion: Post-Evil Boss
Pirate: Pirate
Queen Slime: Post-Queen Bee
Sparkle Slime Balloon: Sparkle Slime Balloon
Diva Slime: Diva Slime
The Great Slime Mitosis: Reward: Grappling Hook
Mythril Ore: Mythril Ore
Mythril Bar: Mythril Bar
Hardmode Anvil: Hardmode Anvil
Mythril Pickaxe: Mythril Pickaxe
Adamantite Ore: Adamantite Ore
Hardmode Forge: Hardmode Forge
Adamantite Bar: Adamantite Bar
Adamantite Pickaxe: Adamantite Pickaxe
Forbidden Armor: Forbidden Armor
Mechanical Eye: Mechanical Eye
Mechanical Worm: Mechanical Worm
Mechanical Skull: Mechanical Skull
The Twins: Post-The Twins
The Destroyer: Post-The Destroyer
Skeletron Prime: Post-Skeletron Prime

Playthrough:

0: {

}
1: {
  Arms Dealer: Arms Dealer
  Evil Boss Part: Evil Boss Part
}
2: {
  Completely Awesome: Post-Skeletron
  Evil Pickaxe: Evil Pickaxe
}
3: {
  Dungeon: Dungeon
  Hellstone: Hellstone
}
4: {
  Bone: Bone
  Hellstone Bar: Hellstone Bar
}
5: {
  Molten Pickaxe: Molten Pickaxe
}
6: {
  Miner for Fire: Hardmode
}
7: {
  Hallow: Hallow
  Mythril Bar: Mythril Bar
  Soul of Night: Soul of Night
}
8: {
  Hardmode Anvil: Hardmode Anvil
  Soul of Light: Soul of Light
}
9: {
  Mechanical Eye: Mechanical Eye
  Mechanical Skull: Mechanical Skull
  Mechanical Worm: Mechanical Worm
}
10: {
  Skeletron Prime: Post-Skeletron Prime
  The Destroyer: Post-The Destroyer
  The Twins: Post-The Twins
}